###############
#A    #       #
### # # ##### #
#   #   #   # #
# ##### # # # #
#     #   #   #
# ### ##### ###
#   #     #   #
# # ##### ### #
# #       #  B#
###############