##########
#A     # #
# ### ## #
# #      #
# # ######
#        B
##########