#####B#
##    #
## ## #
## ## #
#     #
#A#####
